hero_name,num_games,blue_ban_num,red_ban_num,full_ban_num,full_ban_rate,blue_ban_ratio,red_ban_ratio,mbat_team_name,mbat_ban_num,mbat_ban_ratio,blue_pick_num,blue_pick_rate,red_pick_num,red_pick_rate,full_pick_num,full_pick_rate,mpnt_team_name,mpnt_pick_num,mpnt_win_num,mpnt_win_rate,full_bp_num,full_bp_rate,full_win_num,full_lose_num,full_win_rate,full_win_avg_game_time_sec,full_lose_avg_game_time_sec,mwrt_team_name,mwrt_pick_num,mwrt_win_num,mwrt_win_rate
nolan,57,19,31,50,0.8772,0.38,0.62,AP.Bren,13,0.26,6,1,1,1,7,1,ONIC Esports,3,3,1,57,1,7,0,1,902,0,ONIC Esports,3,3,1
guinevere,57,5,36,41,0.7193,0.122,0.878,Blacklist Intl.,13,0.317073171,8,1,8,1,16,1,Geek Fam ID,3,2,0.6667,57,1,7,9,0.4375,1095,1040,ONIC Esports,2,2,1
joy,57,32,20,52,0.9123,0.6154,0.3846,ONIC Esports,15,0.288461538,2,0.6667,2,0.6667,4,0.8,Burmese Ghouls,1,1,1,56,0.9825,2,2,0.5,1228,706,Burmese Ghouls,1,1,1
wanwan,57,18,21,39,0.6842,0.4615,0.5385,Blacklist Intl.,10,0.256410256,4,0.5,10,0.7143,14,0.7778,ONIC Esports,5,4,0.8,53,0.9298,10,4,0.7143,1025,1150,Deus Vult,1,1,1
faramis,57,13,12,25,0.4386,0.52,0.48,Deus Vult,9,0.36,7,0.4667,17,0.68,24,0.75,AP.Bren,6,6,1,49,0.8596,13,11,0.5417,1068,1012,AP.Bren,6,6,1
valentina,57,5,8,13,0.2281,0.3846,0.6154,Blacklist Intl.,4,0.307692308,20,0.6897,15,0.625,35,0.7955,Blacklist Intl.,12,8,0.6667,48,0.8421,18,17,0.5143,955,1119,Blacklist Intl.,12,8,0.6667
mathilda,57,16,12,28,0.4912,0.5714,0.4286,AP.Bren,12,0.428571429,8,0.3636,7,0.3333,15,0.5172,AP.Bren,8,6,0.75,43,0.7544,8,7,0.5333,1036,1108,AP.Bren,8,6,0.75
minotaur,57,16,14,30,0.5263,0.5333,0.4667,AP.Bren,6,0.2,5,0.25,7,0.3182,12,0.4444,Deus Vult,3,1,0.3333,42,0.7368,5,7,0.4167,1077,978,ONIC Esports,2,2,1
bruno,57,4,4,8,0.1404,0.5,0.5,Deus Vult,3,0.375,19,0.5588,15,0.5,34,0.6939,Geek Fam ID,8,3,0.375,42,0.7368,17,17,0.5,1131,1037,Blacklist Intl.,6,5,0.8333
claude,57,7,4,11,0.193,0.6364,0.3636,Blacklist Intl.,4,0.363636364,13,0.4333,16,0.4848,29,0.6304,ONIC Esports,8,4,0.5,40,0.7018,12,17,0.4138,1031,1060,ONIC Esports,8,4,0.5
lylia,57,7,10,17,0.2982,0.4118,0.5882,Geek Fam ID,5,0.294117647,15,0.4412,6,0.24,21,0.525,Fire Flux Esports,5,2,0.4,38,0.6667,6,15,0.2857,1289,1095,Burmese Ghouls,2,1,0.5
terizla,57,5,2,7,0.1228,0.7143,0.2857,Deus Vult,2,0.285714286,15,0.4054,13,0.3714,28,0.56,Deus Vult,9,3,0.3333,35,0.614,14,14,0.5,1115,951,ONIC Esports,8,6,0.75
baxia,57,4,9,13,0.2281,0.3077,0.6923,Blacklist Intl.,6,0.461538462,10,0.2941,10,0.2941,20,0.4545,Deus Vult,8,3,0.375,33,0.5789,8,12,0.4,1262,977,AP.Bren,1,1,1
arlott,57,10,2,12,0.2105,0.8333,0.1667,AP.Bren,5,0.416666667,10,0.2941,11,0.3143,21,0.4667,AP.Bren,8,4,0.5,33,0.5789,7,14,0.3333,904,1032,AP.Bren,8,4,0.5
khaleed,57,11,6,17,0.2982,0.6471,0.3529,Geek Fam ID,7,0.411764706,6,0.1818,7,0.2059,13,0.325,Blacklist Intl.,4,4,1,30,0.5263,8,5,0.6154,1141,990,Blacklist Intl.,4,4,1
tigreal,57,10,4,14,0.2456,0.7143,0.2857,ONIC Esports,6,0.428571429,10,0.2632,5,0.1515,15,0.3488,Fire Flux Esports,4,2,0.5,29,0.5088,7,8,0.4667,1009,1142,Blacklist Intl.,1,1,1
kaja,57,11,6,17,0.2982,0.6471,0.3529,ONIC Esports,10,0.588235294,4,0.1212,7,0.1944,11,0.275,See You Soon,4,1,0.25,28,0.4912,4,7,0.3636,992,808,ONIC Esports,3,2,0.6667
fredrinn,57,3,4,7,0.1228,0.4286,0.5714,Blacklist Intl.,5,0.714285714,11,0.275,10,0.2564,21,0.42,Blacklist Intl.,8,4,0.5,28,0.4912,13,8,0.619,962,1111,AP.Bren,7,6,0.8571
angela,57,7,8,15,0.2632,0.4667,0.5333,AP.Bren,5,0.333333333,6,0.1667,6,0.1667,12,0.2857,Deus Vult,4,1,0.25,27,0.4737,2,10,0.1667,1402,946,AP.Bren,1,1,1
akai,57,4,4,8,0.1404,0.5,0.5,Blacklist Intl.,6,0.75,11,0.2619,7,0.1842,18,0.3673,Blacklist Intl.,7,5,0.7143,26,0.4561,7,11,0.3889,1034,1081,Blacklist Intl.,7,5,0.7143
lapu-lapu,57,5,6,11,0.193,0.4545,0.5455,Blacklist Intl.,3,0.272727273,6,0.1463,5,0.125,11,0.2391,Geek Fam ID,5,1,0.2,22,0.386,4,7,0.3636,882,1144,See You Soon,2,2,1
paquito,57,5,3,8,0.1404,0.625,0.375,AP.Bren,6,0.75,6,0.1395,6,0.1395,12,0.2449,AP.Bren,5,4,0.8,20,0.3509,8,4,0.6667,1046,1190,ONIC Esports,1,1,1
brody,57,2,4,6,0.1053,0.3333,0.6667,AP.Bren,1,0.166666667,6,0.1395,8,0.1778,14,0.2745,AP.Bren,8,7,0.875,20,0.3509,8,6,0.5714,1040,939,AP.Bren,8,7,0.875
novaria,57,4,2,6,0.1053,0.6667,0.3333,Deus Vult,2,0.333333333,9,0.1957,5,0.119,14,0.2745,AP.Bren,6,4,0.6667,20,0.3509,8,6,0.5714,1115,1016,ONIC Esports,3,3,1
diggie,57,3,12,15,0.2632,0.2,0.8,Deus Vult,6,0.4,1,0.0256,3,0.0732,4,0.0952,Deus Vult,3,3,1,19,0.3333,4,0,1,1120,0,Deus Vult,3,3,1
fanny,57,17,0,17,0.2982,1,0,ONIC Esports,7,0.411764706,1,0.025,0,0,1,0.025,Fire Flux Esports,1,1,1,18,0.3158,1,0,1,995,0,Fire Flux Esports,1,1,1
ixia,57,5,8,13,0.2281,0.3846,0.6154,Fire Flux Esports,5,0.384615385,4,0.093,1,0.025,5,0.1136,Deus Vult,2,1,0.5,18,0.3158,3,2,0.6,926,1021,Blacklist Intl.,1,1,1
dyrroth,57,5,2,7,0.1228,0.7143,0.2857,ONIC Esports,4,0.571428571,5,0.1136,6,0.1333,11,0.22,ONIC Esports,4,3,0.75,18,0.3158,6,5,0.5455,1156,856,AP.Bren,1,1,1
martis,57,2,2,4,0.0702,0.5,0.5,AP.Bren,1,0.25,4,0.0909,9,0.1837,13,0.2453,See You Soon,4,3,0.75,17,0.2982,6,7,0.4615,915,1179,ONIC Esports,1,1,1
phoveus,57,7,5,12,0.2105,0.5833,0.4167,AP.Bren,3,0.25,0,0,3,0.0667,3,0.0667,AP.Bren,2,1,0.5,15,0.2632,2,1,0.6667,912,1357,ONIC Esports,1,1,1
edith,57,5,2,7,0.1228,0.7143,0.2857,Blacklist Intl.,7,1,6,0.1224,1,0.0227,7,0.14,Blacklist Intl.,4,2,0.5,14,0.2456,4,3,0.5714,928,1185,AP.Bren,2,2,1
ruby,57,2,2,4,0.0702,0.5,0.5,Geek Fam ID,3,0.75,5,0.1,3,0.0625,8,0.1509,Geek Fam ID,4,3,0.75,12,0.2105,6,2,0.75,1119,892,ONIC Esports,1,1,1
lancelot,57,4,0,4,0.0702,1,0,See You Soon,4,1,3,0.0612,4,0.08,7,0.1321,See You Soon,4,2,0.5,11,0.193,3,4,0.4286,993,935,See You Soon,4,2,0.5
kadita,57,1,4,5,0.0877,0.2,0.8,ONIC Esports,5,1,0,0,5,0.0962,5,0.0962,ONIC Esports,3,2,0.6667,10,0.1754,3,2,0.6,1099,740,ONIC Esports,3,2,0.6667
uranus,57,2,3,5,0.0877,0.4,0.6,Deus Vult,3,0.6,1,0.0204,3,0.0588,4,0.0769,Burmese Ghouls,2,0,0,9,0.1579,2,2,0.5,1292,1302,Deus Vult,1,1,1
beatrix,57,1,2,3,0.0526,0.3333,0.6667,Deus Vult,2,0.666666667,5,0.0943,1,0.0204,6,0.1111,Fire Flux Esports,3,1,0.3333,9,0.1579,3,3,0.5,1028,1139,Deus Vult,1,1,1
gord,57,1,1,2,0.0351,0.5,0.5,AP.Bren,1,0.5,2,0.0385,3,0.0566,5,0.0909,ONIC Esports,2,2,1,7,0.1228,5,0,1,1021,0,ONIC Esports,2,2,1
karrie,57,0,1,1,0.0175,0,1,Fire Flux Esports,1,1,2,0.0385,4,0.0741,6,0.1071,Blacklist Intl.,3,2,0.6667,7,0.1228,3,3,0.5,894,887,ONIC Esports,1,1,1
yu zhong,57,0,0,0,0,0,0,,0,0,2,0.0385,5,0.0909,7,0.1228,See You Soon,3,2,0.6667,7,0.1228,4,3,0.5714,890,1266,Deus Vult,1,1,1
rafaela,57,1,0,1,0.0175,1,0,Blacklist Intl.,1,1,3,0.0556,2,0.0377,5,0.0893,Blacklist Intl.,5,5,1,6,0.1053,5,0,1,1163,0,Blacklist Intl.,5,5,1
chou,57,1,0,1,0.0175,1,0,ONIC Esports,1,1,2,0.0377,3,0.0556,5,0.0893,See You Soon,3,2,0.6667,6,0.1053,3,2,0.6,911,1398,See You Soon,3,2,0.6667
grock,57,0,1,1,0.0175,0,1,AP.Bren,1,1,2,0.0377,3,0.0556,5,0.0893,ONIC Esports,2,2,1,6,0.1053,3,2,0.6,993,1432,ONIC Esports,2,2,1
estes,57,1,1,2,0.0351,0.5,0.5,Blacklist Intl.,2,1,1,0.0189,2,0.037,3,0.0545,Blacklist Intl.,3,2,0.6667,5,0.0877,2,1,0.6667,966,1101,Blacklist Intl.,3,2,0.6667
gloo,57,0,1,1,0.0175,0,1,Fire Flux Esports,1,1,2,0.037,2,0.037,4,0.0714,Burmese Ghouls,2,1,0.5,5,0.0877,3,1,0.75,1131,803,AP.Bren,1,1,1
thamuz,57,0,1,1,0.0175,0,1,AP.Bren,1,1,3,0.0545,1,0.0189,4,0.0714,AP.Bren,3,2,0.6667,5,0.0877,2,2,0.5,871,1090,AP.Bren,3,2,0.6667
benedetta,57,1,1,2,0.0351,0.5,0.5,AP.Bren,1,0.5,1,0.0185,1,0.0185,2,0.0364,AP.Bren,1,1,1,4,0.0702,1,1,0.5,665,1805,AP.Bren,1,1,1
hilda,57,1,1,2,0.0351,0.5,0.5,Blacklist Intl.,1,0.5,0,0,2,0.0364,2,0.0364,Blacklist Intl.,1,0,0,4,0.0702,0,2,0,0,787,Blacklist Intl.,1,0,0
khufra,57,0,1,1,0.0175,0,1,ONIC Esports,1,1,0,0,3,0.0536,3,0.0536,See You Soon,1,1,1,4,0.0702,1,2,0.3333,870,1276,See You Soon,1,1,1
irithel,57,0,0,0,0,0,0,,0,0,3,0.0536,1,0.0185,4,0.0702,Fire Flux Esports,2,0,0,4,0.0702,0,4,0,0,1027,Fire Flux Esports,2,0,0
helcurt,57,0,1,1,0.0175,0,1,See You Soon,1,1,0,0,2,0.0357,2,0.0357,See You Soon,1,1,1,3,0.0526,1,1,0.5,1112,1075,See You Soon,1,1,1
leomord,57,1,0,1,0.0175,1,0,Fire Flux Esports,1,1,2,0.0357,0,0,2,0.0357,Fire Flux Esports,2,1,0.5,3,0.0526,1,1,0.5,908,1057,Fire Flux Esports,2,1,0.5
yve,57,0,0,0,0,0,0,,0,0,1,0.0182,2,0.0357,3,0.0526,Geek Fam ID,2,2,1,3,0.0526,2,1,0.6667,1086,842,Geek Fam ID,2,2,1
x.borg,57,0,1,1,0.0175,0,1,Fire Flux Esports,1,1,1,0.0179,0,0,1,0.0179,Geek Fam ID,1,0,0,2,0.0351,0,1,0,0,1359,Geek Fam ID,1,0,0
odette,57,0,0,0,0,0,0,,0,0,1,0.0179,1,0.0179,2,0.0351,AP.Bren,2,1,0.5,2,0.0351,1,1,0.5,665,709,AP.Bren,2,1,0.5
hayabusa,57,0,0,0,0,0,0,,0,0,1,0.0179,1,0.0179,2,0.0351,ONIC Esports,1,0,0,2,0.0351,0,2,0,0,763,ONIC Esports,1,0,0
floryn,57,0,0,0,0,0,0,,0,0,2,0.0351,0,0,2,0.0351,Blacklist Intl.,2,0,0,2,0.0351,0,2,0,0,1058,Blacklist Intl.,2,0,0
gusion,57,0,0,0,0,0,0,,0,0,1,0.0175,0,0,1,0.0175,ONIC Esports,1,1,1,1,0.0175,1,0,1,746,0,ONIC Esports,1,1,1
harith,57,0,0,0,0,0,0,,0,0,1,0.0175,0,0,1,0.0175,ONIC Esports,1,1,1,1,0.0175,1,0,1,746,0,ONIC Esports,1,1,1
franco,57,0,0,0,0,0,0,,0,0,0,0,1,0.0175,1,0.0175,Burmese Ghouls,1,0,0,1,0.0175,0,1,0,0,813,Burmese Ghouls,1,0,0
clint,57,0,0,0,0,0,0,,0,0,0,0,1,0.0175,1,0.0175,AP.Bren,1,0,0,1,0.0175,0,1,0,0,1357,AP.Bren,1,0,0
lunox,57,0,0,0,0,0,0,,0,0,0,0,1,0.0175,1,0.0175,Fire Flux Esports,1,0,0,1,0.0175,0,1,0,0,904,Fire Flux Esports,1,0,0
aamon,57,0,0,0,0,0,0,,0,0,0,0,1,0.0175,1,0.0175,Fire Flux Esports,1,0,0,1,0.0175,0,1,0,0,666,Fire Flux Esports,1,0,0
miya,57,0,0,0,0,0,0,,0,0,0,0,0,0,0,0,,0,0,0,0,0,0,0,0,0,0,,0,0,0
balmond,57,0,0,0,0,0,0,,0,0,0,0,0,0,0,0,,0,0,0,0,0,0,0,0,0,0,,0,0,0
saber,57,0,0,0,0,0,0,,0,0,0,0,0,0,0,0,,0,0,0,0,0,0,0,0,0,0,,0,0,0
alice,57,0,0,0,0,0,0,,0,0,0,0,0,0,0,0,,0,0,0,0,0,0,0,0,0,0,,0,0,0
nana,57,0,0,0,0,0,0,,0,0,0,0,0,0,0,0,,0,0,0,0,0,0,0,0,0,0,,0,0,0
alucard,57,0,0,0,0,0,0,,0,0,0,0,0,0,0,0,,0,0,0,0,0,0,0,0,0,0,,0,0,0
karina,57,0,0,0,0,0,0,,0,0,0,0,0,0,0,0,,0,0,0,0,0,0,0,0,0,0,,0,0,0
bane,57,0,0,0,0,0,0,,0,0,0,0,0,0,0,0,,0,0,0,0,0,0,0,0,0,0,,0,0,0
eudora,57,0,0,0,0,0,0,,0,0,0,0,0,0,0,0,,0,0,0,0,0,0,0,0,0,0,,0,0,0
zilong,57,0,0,0,0,0,0,,0,0,0,0,0,0,0,0,,0,0,0,0,0,0,0,0,0,0,,0,0,0
layla,57,0,0,0,0,0,0,,0,0,0,0,0,0,0,0,,0,0,0,0,0,0,0,0,0,0,,0,0,0
lolita,57,0,0,0,0,0,0,,0,0,0,0,0,0,0,0,,0,0,0,0,0,0,0,0,0,0,,0,0,0
freya,57,0,0,0,0,0,0,,0,0,0,0,0,0,0,0,,0,0,0,0,0,0,0,0,0,0,,0,0,0
natalia,57,0,0,0,0,0,0,,0,0,0,0,0,0,0,0,,0,0,0,0,0,0,0,0,0,0,,0,0,0
kagura,57,0,0,0,0,0,0,,0,0,0,0,0,0,0,0,,0,0,0,0,0,0,0,0,0,0,,0,0,0
sun,57,0,0,0,0,0,0,,0,0,0,0,0,0,0,0,,0,0,0,0,0,0,0,0,0,0,,0,0,0
alpha,57,0,0,0,0,0,0,,0,0,0,0,0,0,0,0,,0,0,0,0,0,0,0,0,0,0,,0,0,0
yi sun-shin,57,0,0,0,0,0,0,,0,0,0,0,0,0,0,0,,0,0,0,0,0,0,0,0,0,0,,0,0,0
moskov,57,0,0,0,0,0,0,,0,0,0,0,0,0,0,0,,0,0,0,0,0,0,0,0,0,0,,0,0,0
johnson,57,0,0,0,0,0,0,,0,0,0,0,0,0,0,0,,0,0,0,0,0,0,0,0,0,0,,0,0,0
cyclops,57,0,0,0,0,0,0,,0,0,0,0,0,0,0,0,,0,0,0,0,0,0,0,0,0,0,,0,0,0
aurora,57,0,0,0,0,0,0,,0,0,0,0,0,0,0,0,,0,0,0,0,0,0,0,0,0,0,,0,0,0
vexana,57,0,0,0,0,0,0,,0,0,0,0,0,0,0,0,,0,0,0,0,0,0,0,0,0,0,,0,0,0
roger,57,0,0,0,0,0,0,,0,0,0,0,0,0,0,0,,0,0,0,0,0,0,0,0,0,0,,0,0,0
gatotkaca,57,0,0,0,0,0,0,,0,0,0,0,0,0,0,0,,0,0,0,0,0,0,0,0,0,0,,0,0,0
harley,57,0,0,0,0,0,0,,0,0,0,0,0,0,0,0,,0,0,0,0,0,0,0,0,0,0,,0,0,0
argus,57,0,0,0,0,0,0,,0,0,0,0,0,0,0,0,,0,0,0,0,0,0,0,0,0,0,,0,0,0
hylos,57,0,0,0,0,0,0,,0,0,0,0,0,0,0,0,,0,0,0,0,0,0,0,0,0,0,,0,0,0
zhask,57,0,0,0,0,0,0,,0,0,0,0,0,0,0,0,,0,0,0,0,0,0,0,0,0,0,,0,0,0
pharsa,57,0,0,0,0,0,0,,0,0,0,0,0,0,0,0,,0,0,0,0,0,0,0,0,0,0,,0,0,0
lesley,57,0,0,0,0,0,0,,0,0,0,0,0,0,0,0,,0,0,0,0,0,0,0,0,0,0,,0,0,0
jawhead,57,0,0,0,0,0,0,,0,0,0,0,0,0,0,0,,0,0,0,0,0,0,0,0,0,0,,0,0,0
valir,57,0,0,0,0,0,0,,0,0,0,0,0,0,0,0,,0,0,0,0,0,0,0,0,0,0,,0,0,0
hanabi,57,0,0,0,0,0,0,,0,0,0,0,0,0,0,0,,0,0,0,0,0,0,0,0,0,0,,0,0,0
chang'e,57,0,0,0,0,0,0,,0,0,0,0,0,0,0,0,,0,0,0,0,0,0,0,0,0,0,,0,0,0
selena,57,0,0,0,0,0,0,,0,0,0,0,0,0,0,0,,0,0,0,0,0,0,0,0,0,0,,0,0,0
aldous,57,0,0,0,0,0,0,,0,0,0,0,0,0,0,0,,0,0,0,0,0,0,0,0,0,0,,0,0,0
vale,57,0,0,0,0,0,0,,0,0,0,0,0,0,0,0,,0,0,0,0,0,0,0,0,0,0,,0,0,0
hanzo,57,0,0,0,0,0,0,,0,0,0,0,0,0,0,0,,0,0,0,0,0,0,0,0,0,0,,0,0,0
belerick,57,0,0,0,0,0,0,,0,0,0,0,0,0,0,0,,0,0,0,0,0,0,0,0,0,0,,0,0,0
kimmy,57,0,0,0,0,0,0,,0,0,0,0,0,0,0,0,,0,0,0,0,0,0,0,0,0,0,,0,0,0
minsitthar,57,0,0,0,0,0,0,,0,0,0,0,0,0,0,0,,0,0,0,0,0,0,0,0,0,0,,0,0,0
badang,57,0,0,0,0,0,0,,0,0,0,0,0,0,0,0,,0,0,0,0,0,0,0,0,0,0,,0,0,0
granger,57,0,0,0,0,0,0,,0,0,0,0,0,0,0,0,,0,0,0,0,0,0,0,0,0,0,,0,0,0
esmeralda,57,0,0,0,0,0,0,,0,0,0,0,0,0,0,0,,0,0,0,0,0,0,0,0,0,0,,0,0,0
ling,57,0,0,0,0,0,0,,0,0,0,0,0,0,0,0,,0,0,0,0,0,0,0,0,0,0,,0,0,0
masha,57,0,0,0,0,0,0,,0,0,0,0,0,0,0,0,,0,0,0,0,0,0,0,0,0,0,,0,0,0
silvanna,57,0,0,0,0,0,0,,0,0,0,0,0,0,0,0,,0,0,0,0,0,0,0,0,0,0,,0,0,0
cecilion,57,0,0,0,0,0,0,,0,0,0,0,0,0,0,0,,0,0,0,0,0,0,0,0,0,0,,0,0,0
carmilla,57,0,0,0,0,0,0,,0,0,0,0,0,0,0,0,,0,0,0,0,0,0,0,0,0,0,,0,0,0
atlas,57,0,0,0,0,0,0,,0,0,0,0,0,0,0,0,,0,0,0,0,0,0,0,0,0,0,,0,0,0
popol and kupa,57,0,0,0,0,0,0,,0,0,0,0,0,0,0,0,,0,0,0,0,0,0,0,0,0,0,,0,0,0
luo yi,57,0,0,0,0,0,0,,0,0,0,0,0,0,0,0,,0,0,0,0,0,0,0,0,0,0,,0,0,0
barats,57,0,0,0,0,0,0,,0,0,0,0,0,0,0,0,,0,0,0,0,0,0,0,0,0,0,,0,0,0
natan,57,0,0,0,0,0,0,,0,0,0,0,0,0,0,0,,0,0,0,0,0,0,0,0,0,0,,0,0,0
aulus,57,0,0,0,0,0,0,,0,0,0,0,0,0,0,0,,0,0,0,0,0,0,0,0,0,0,,0,0,0
yin,57,0,0,0,0,0,0,,0,0,0,0,0,0,0,0,,0,0,0,0,0,0,0,0,0,0,,0,0,0
melissa,57,0,0,0,0,0,0,,0,0,0,0,0,0,0,0,,0,0,0,0,0,0,0,0,0,0,,0,0,0
xavier,57,0,0,0,0,0,0,,0,0,0,0,0,0,0,0,,0,0,0,0,0,0,0,0,0,0,,0,0,0
julian,57,0,0,0,0,0,0,,0,0,0,0,0,0,0,0,,0,0,0,0,0,0,0,0,0,0,,0,0,0
cici,57,0,0,0,0,0,0,,0,0,0,0,0,0,0,0,,0,0,0,0,0,0,0,0,0,0,,0,0,0
